1111111111111111111111111111111
1NNNNNNNNNNNNNNNNNNNNNNNNNNNNN1
1N000000000000000000000000000N1
1N011101010111010101010101110N1
1N000001000000000000000000010N1
1N010101010101110101010101010N1
1N010000010000000000000000010N1
1N010101010101011101010111010N1
1N000100000100000000000000000N1
1N010101010101010111010101010N1
1N000000000000000000010000000N1
1N010101010101010101010101010N1
1N010000000000000100000100000N1
1N010101011101010101010101010N1
1N000001000000P0C000000001000N1
1N0101010101010N0101010101010N1
1N000000000000C0E000000000010N1
1N010111010101010101010101110N1
1N000000000000000000000000010N1
1N010101110101010101110101010N1
1N000100000000000000000001000N1
1N010101010101010101010101010N1
1N000000000001000000000000000N1
1N010101010101010111010101010N1
1N000000010000000000000000000N1
1N010111010101010101010111010N1
1N010000000100000000010000010N1
1N010101110101011101010101110N1
1N000000000000000000000000000N1
1000000000000000000000000000001
1111111111111111111111111111111
