1111111111111
10c1000000001
1000011111C01
1P0011E000001
1111111111111
