111111111111111111111111111111111111111111111111111111111111111111111111111111111111111111111111111
1CCCC1CCCCCCCCCCCCCCCCCCCCCCCCCCCCCCCC1C1C1CC101CCCCCCCCCCCCCCCCCCCCCCCCCCCCCCCCCCCCCC1CCCCCCCCCCC1
1CCCC1CCCCCCCCCCCCCCCCCCCCCCCCCCCCCC11CCCCNCCC1CCCCCCCCCCCCCCCCCCCCCCCCCCCCCCCCCCCCCCC1CCCCCCCCCCC1
1CCCC1CCCCCCCCCCCCCCCCCCCCCCCCCCCCCC1CECCCNCCCC1CCCCCCCCCCCCCCCCCCCCCCCCCCCCCCCCCCCCCC1CCCCCCCCCCC1
1CCCC1CCCCCCPCCCCCCCCCCCCCCCCCCCCCCC1CCCCCCCCCC1C11CCC111111111111111111111111111111111CCCCCCCCCCC1
1CCCC1CCCCCCCCCCCCCCCCCCCCCCCCCCCCCCCC111C1CCCC1CCCCCCCCCCCCCCCCCCCCCCCCCCCCCCCCCCCCCCCCCCCCCCCCCC1
1CCCCCCCCNCCNCCCCCCCCCCCCCCCCCCCCCCCCCCCCCCCCCCCCCCCCCCCCCCCCCCCCCCCCCCCCCCCCCCCCCCCCCCCCCCCCCCCCC1
1CCCCCCCCCCCCCCCCCCCCCCCCCCCCCCCCCCCCCCCCCCCCCCCCCCCCCCCCCCCCCCCCCCCCCCCCCCCCCCCCCCCCCCCCCCCCCCCCC1
1CCCCCCCCCCCCCCCCCCCCCCCCCCCCCCCCCCCCCCCCCCCCCCCCCCCCCCCCCCCCCCCCCCCCCCCCCCCCCCCCCCCCCCCCCCCCCCCCC1
111111111111111111111111111111111111111111111111111111111111111111111111111111111111111111111111111
